.............
........x....
...*.#.......
........o....
...*....o....
.............
.............
..........................